20
XXXXXXXXXXXXXXXXXXX
XXX     00XXXXXXXXX
XXX0    00XXXXXXXXX
XXX0     XXXXXXXXXX
XXX0     XXXXXXXXXX
XXX0            XXX
XXX1            XXX
XXX1            XXX
XXXX            XXX
X               XXX
X               XXX
X2              XXX
X2              XXX
XX  000XX  X2XXXXXX
XX  000XX  X2XXXXXX
XXXXXXXXX XXXXXXXXX
XXXXXXXXX XXXXXXXXX
XXXXXXXXX XXXXXXXXX
XXXXXXXXX XXXXXXXXX
XXXXXXXXXXXXXXXXXXX
