12
XXXXXXXXXXXXXXXX
X          1   X
X          1   X
X          XX  X
X          XX  X
X              X
X              X
X 02   2     0 X
X 02   2     0 X
XXXXX1 XX XXXXXX
XXXXX1 XX XXXXXX
XXXXXXXXXXXXXXXX
