16
XXXXXXXXXXXXXXX
X01           X
X01           X
X011     111  X
X011     111  X
XXXX     222  X
XXXX    X222X X
XXXX    X212X X
XXXX    X212X X
XXXX     000  X
XXXX     000  X
XXXXX    000  X
XXXXX    000  X
XXXXX   XXXXXXX
XXXXX  XXXXXXXX
XXXXXXXXXXXXXXX
