20
XXXXXXXXXXXXXXXXXXXXXXXXXXXXXXXXXX
XXXXX          0000XXXXXXXXXXXXXXX
XXXXX00        0000XXXXXXXXXXXXXXX
XXXXX00          XXXXXXXXXXXXXXXXX
XXXXX00          XXXXXXXXXXXXXXXXX
XXXXX00                        XXX
XXXXX11                        XXX
XXXXX11                        XXX
XXXXXXX                        XXX
X                              XXX
X                              XXX
X22                            XXX
X22                            XXX
XXX    000000XXXX    XX22XXXXXXXXX
XXX    000000XXXX    XX22XXXXXXXXX
XXXXXXXXXXXXXXXXX  XXXXXXXXXXXXXXX
XXXXXXXXXXXXXXXXX  XXXXXXXXXXXXXXX
XXXXXXXXXXXXXXXXX  XXXXXXXXXXXXXXX
XXXXXXXXXXXXXXXXX  XXXXXXXXXXXXXXX
XXXXXXXXXXXXXXXXXXXXXXXXXXXXXXXXXX
